10,10,10,10,10,10,10,10,10,10,10,10,10,10,10,10,10,10,10,10,10,10,10,10,10,10
10,0,10,10,0,0,0,0,0,10,10,10,10,10,10,10,0,0,10,10,10,10,10,10,10,10
10,0,10,0,0,0,0,0,0,10,10,10,10,10,10,0,0,0,0,0,0,0,10,10,10,10
10,0,10,0,0,0,10,0,0,10,10,10,10,10,10,0,0,0,0,0,0,0,10,10,10,10
10,0,10,0,0,10,0,0,0,0,0,0,10,0,0,0,0,10,0,0,0,0,0,0,10,10
10,0,0,0,0,10,0,10,0,0,0,0,0,0,0,0,0,0,0,0,10,0,0,0,10,10
10,0,0,0,0,0,0,0,0,0,0,0,0,0,0,0,0,0,0,0,0,0,0,10,10,10
10,3,0,0,0,0,0,0,0,10,10,0,0,0,0,0,0,0,10,10,10,0,0,10,10,10
10,10,2,3,0,0,0,0,0,10,10,10,0,0,0,0,0,0,10,10,10,0,0,10,10,10
10,10,10,10,10,10,0,10,10,10,10,10,10,0,0,0,0,0,10,10,10,0,0,10,10,10
10,10,10,10,10,10,0,10,10,10,10,10,10,0,0,0,0,10,10,10,0,0,0,10,10,10
10,10,0,0,10,0,0,0,10,10,10,10,10,0,0,0,10,10,10,0,0,0,0,0,10,10
10,10,10,0,0,0,0,0,10,10,10,10,0,0,0,0,10,10,10,0,0,0,0,0,10,10
10,10,10,10,0,0,0,0,0,0,0,0,0,0,0,0,0,0,0,0,0,0,0,0,10,10
10,10,10,10,10,10,10,0,0,0,0,0,10,10,10,0,0,0,0,0,0,0,0,10,10,10
10,10,10,10,10,10,10,10,10,10,10,10,10,10,10,10,10,10,10,0,0,10,10,10,10,10
10,10,10,10,10,10,10,10,10,10,10,10,10,10,10,10,10,10,10,10,10,10,10,10,10,10
